....................
.........CCCC.......
........CC...C......
........CCCCC.......
....................
....................
....................
....................
...........###......
......CCC...........
......###.......CCC.
................###.
.###................
....................
####################
